{
  "name" : "Level2 Test",
  "width_in_tiles"  : 200,
  "height_in_tiles" : 12,

  "player_start_pos" : [20, 20],

  "tileset" : "tileset1",

  "background" : "level2_bg.png",
  "tiles" : [
    [2, -1, -1, -1, -1, -1, -1, -1, -1, -1, -1, 2],
    [0, -1, -1, -1, -1, -1, -1, -1, -1, -1, -1, 0],
    [0, -1, -1, -1, -1, -1, -1, -1, -1, -1, -1, 0],
    [0, -1, -1, -1, -1, -1, -1, -1, -1, -1, -1, 0],
    [0, -1, -1, -1, -1, -1, -1, -1, -1, -1, -1, 0],
    [0, -1, -1, -1, -1, -1, -1, -1, -1, -1, -1, 0],
    [0, -1, -1, -1, -1, -1, -1, -1, -1, -1, -1, 0],
    [0, -1, -1, -1, -1, -1, -1, -1, -1, -1, -1, 0],
    [0, -1, -1, -1, -1, -1, -1, -1, -1, -1, -1, -1],
    [0, -1, -1, -1, -1, -1, -1, -1, -1, -1, -1, -1],
    [0, -1, -1, -1, -1, 5, -1, -1, -1, -1, -1, -1, -1, -1, -1, -1, -1, 5],
    [3, 3, 3, 3, 3, 3, 3, 3, 3, 3, 3, 3, 3, 3, 3, 3, 3, 3, 3, 3, 3, 3, 3, 3, 3, 3, 3, 3, 3, 3, 3, 3, 3, 3, 3, 3, 3, 3, 3, 3, 3, 3, 3, 3, 3, 3, 3, 3, 3, 3, 3, 3, 3, 3, 3, 3, 3, 3, 3, 3, 3, 3, 3, 3, 3, 3, 3, 3, 3, 3, 3, 3, 3, 3, 3, 3, 3, 3, 3, 3, 3, 3, 3, 3, 3, 3, 3, 3, 3, 3, 3, 3, 3, 3, 3, 3, 3, 3, 3, 3, 3, 3, 3, 3, 3, 3, 3, 3, 3, 3, 3, 3, 3, 3, 3, 3, 3, 3, 3, 3, 3, 3, 3, 3, 3, 3, 3, 3, 3, 3, 3, 3, 3, 3, 3, 3, 3, 3, 3, 3, 3, 3, 3, 3, 3, 3, 3, 3, 3, 3, 3, 3, 3, 3, 3, 3, 3, 3, 3, 3, 3, 3, 3, 3, 3, 3, 3, 3, 3, 3, 3, 3, 3, 3, 3, 3, 3, 3, 3, 3, 3, 3, 3]
  ]
}
