{
  "name" : "Level2 Test",
  "width_in_tiles" : 32,
  "height_in_tiles" : 24,

  "player_start_pos" : [440, 100],

  "tileset" : {
    "image" : "tileset2.png",
    "tiles" : [
      [0,   0, 32, 32],
      [32,  0, 32, 32],
      [64,  0, 32, 32],
      [96,  0, 32, 32],

      [0,  32, 32, 32],
      [32, 32, 32, 32],
      [0,  64, 32, 32],
      [32, 64, 32, 32],

      [64, 32, 32, 32],
      [96, 32, 32, 32],
      [64, 64, 32, 32],
      [96, 64, 32, 32],
      [0 , 96, 32, 32],
      [32 , 96, 32, 32],
      [64 , 96, 32, 32],
      [96 , 96, 32, 32]
    ]
  },

  "background" : "level1_bg.png",
  "tiles" : [
    [3, -1, -1, -1, -1, -1, -1, -1, -1, -1, -1, 12],
    [3, -1, -1, -1, -1, -1, -1, -1, -1, -1, -1, -1],
    [3, -1, -1, -1, -1, -1, -1, -1, -1, -1, -1, -1],
    [3, -1, -1, -1, -1, -1, -1, -1, -1, -1, -1, -1],
    [3, -1, -1, -1, -1, -1, -1, -1, -1, -1, -1, -1],
    [3, -1, -1, -1, -1, -1, -1, -1, -1, -1, -1, -1],
    [3, -1, -1, -1, -1, -1, -1, -1, -1, -1, -1, 12],
    [3, -1, -1, -1, -1, -1, -1, -1, -1, -1, -1, -1],
    [15, 11, 11, 11, 11, 11, 11, 11, 11, 11, 11, 11, 11, 11, 11, 11, 11, 11, 11, 11, 11, 11, 11, 11, 11, 11, 13],
    [3],
    [3],
    [3],
    [3],
    [3],
    [3],
    [3, -1, -1, -1, -1, -1, -1, -1, -1, -1, -1, -1, -1, -1, -1, -1, -1, -1, -1, -1, -1, -1, 10],
    [3, -1, -1, -1, -1, -1, -1, -1, -1, -1, -1, -1, -1, -1, -1, -1, -1, -1, -1, -1, -1, -1, 9],
    [3, -1, -1, -1, -1, -1, -1, -1, -1, -1, -1, -1, -1, -1, -1, -1, -1, -1, -1, -1, -1, -1, 9],
    [3, -1, -1, -1, 4, 5, -1, -1, -1, -1, -1, -1, -1, -1, -1, -1, -1, -1, -1, -1, -1, -1, 9],
    [3, -1, -1, -1, 6, 7, -1, -1, 12, -1, -1, -1, -1, -1, -1, -1, -1, -1, -1, -1, -1, -1, 9],
    [3, -1, -1, -1, -1, -1, -1, 10, -1, -1, -1, -1, -1, -1, -1, -1, -1, -1, -1, -1, -1, -1, 9],
    [14, 0, 0, 0, 0, 0, 0, 8, 0, 0, 0, 0, 0, 0, 0, 0, 0, 0, 0, 0, 0, 0, 8, 0, 0, 0, 0]
  ]
}
